Xu, Xu, Xu, Xu, Xu, Xu, Xu, Xu, Xu, Xu, Xu, Xu, Xu, Xu, Xu, Xu, Xu, Xu, Xu, Xu, Xu, Xu, Xu, Xu, Xu, Xu, Xu, Xu, Xu, Xu, Xu, Xu, Xu, Xu, Xu, Xu, Xu, Xu, Xu, Xu, Xu, Xu, Xu, Xu, Xu, Xu, Xu, Xu, Xu, Xu, Xu, Xu, Xu, Xu, Xu, Xu, Xu, Xu, Xu, Xu, Xu
Xu, Re, Re, Gg, Gg, Re, Re, Gg, Gg, Re, Re, Gg, Gg, Re, Re, Gg, Gg, Re, Re, Gg, Gg, Re, Re, Gg, Gg, Re, Re, Gg, Gg, Re, Re, Gg, Gg, Re, Re, Gg, Gg, Re, Re, Gg, Gg, Re, Re, Gg, Gg, Re, Re, Gg, Gg, Re, Re, Gg, Gg, Re, Re, Gg, Gg, Re, Re, Gg, Xu
Xu, Gg, Gg, Re, Re, Gg, Gg, Re, Re, Gg, Gg, Re, Re, Gg, Gg, Re, Re, Gg, Gg, Re, Re, Gg, Gg, Re, Re, Gg, Gg, Re, Re, Gg, Gg, Re, Re, Gg, Gg, Re, Re, Gg, Gg, Re, Re, Gg, Gg, Re, Re, Gg, Gg, Re, Re, Gg, Gg, Re, Re, Gg, Gg, Re, Re, Gg, Gg, Re, Xu
Xu, Re, Re, Gg, Gg, Re, Re, Gg, Gg, Re, Re, Gg, Gg, Re, Re, Gg, Gg, Re, Re, Gg, Gg, Re, Re, Gg, Gg, Re, Re, Gg, Gg, Re, Xu, Gg, Gg, Re, Re, Gg, Gg, Re, Re, Gg, Gg, Re, Re, Gg, Gg, Re, Re, Gg, Gg, Re, Re, Gg, Gg, Re, Re, Gg, Gg, Re, Re, Gg, Xu
Xu, Gg, Gg, Re, Re, Gg, Gg, Re, Re, Gg, Gg, Re, Re, Gg, Gg, Re, Re, Gg, Gg, Re, Re, Gg, Gg, Re, Re, Gg, Gg, Re, Xu, Xu, Qxu, Xu, Xu, Gg, Gg, Re, Re, Gg, Gg, Re, Re, Gg, Gg, Re, Re, Gg, Gg, Re, Re, Gg, Gg, Re, Re, Gg, Gg, Re, Re, Gg, Gg, Re, Xu
Xu, Re, Re, Gg, Gg, Re, Re, Gg, Gg, Re, Re, Gg, Gg, Re, Re, Gg, Gg, Re, Re, Gg, Gg, Re, Re, Gg, Gg, Re, Xu, Xu, Ss, Ss, Ss, Ss, Ss, Xu, Xu, Gg, Gg, Re, Re, Gg, Gg, Re, Re, Gg, Gg, Re, Re, Gg, Gg, Re, Re, Gg, Gg, Re, Re, Gg, Gg, Re, Re, Gg, Xu
Xu, Gg, Gg, Re, Re, Gg, Gg, Re, Re, Gg, Gg, Re, Re, Gg, Gg, Re, Re, Gg, Gg, Re, Re, Gg, Gg, Re, Xu, Xu, Ds, Ss, Gg, Gg, Gg^Vh, Gg, Gg, Ss, Ds, Xu, Xu, Gg, Gg, Re, Re, Gg, Gg, Re, Re, Gg, Gg, Re, Re, Gg, Gg, Re, Re, Gg, Gg, Re, Re, Gg, Gg, Re, Xu
Xu, Re, Re, Gg, Gg, Re, Re, Gg, Gg, Re, Re, Gg, Gg, Re, Re, Gg, Gg, Re, Re, Gg, Gg, Re, Xu, Xu, Gg, Ds, Gg, Chs, Chs, Gg, Gg, Gg, Chs, Chs, Gg, Ds, Gg, Xu, Xu, Gg, Gg, Re, Re, Gg, Gg, Re, Re, Gg, Gg, Re, Re, Gg, Gg, Re, Re, Gg, Gg, Re, Re, Gg, Xu
Xu, Gg, Gg, Re, Re, Gg, Gg, Re, Re, Gg, Gg, Re, Re, Gg, Gg, Re, Re, Gg, Gg, Re, Xu, Xu, Ss, Gg, Rr, Hh, Gs^Fp, Gg, Gg, Gg, Uh, Gg, Gg, Gg, Gs^Fp, Hh, Rr, Gg, Ss, Xu, Xu, Gg, Gg, Re, Re, Gg, Gg, Re, Re, Gg, Gg, Re, Re, Gg, Gg, Re, Re, Gg, Gg, Re, Xu
Xu, Re, Re, Gg, Gg, Re, Re, Gg, Gg, Re, Re, Gg, Gg, Re, Re, Gg, Gg, Re, Xu, Xu, Gg, Gg, Gg, Gg, Gg, Gs^Fp, Gs^Fp, Gs^Fp, Gg, Gg, Gs^Fp, Gg, Gg, Gs^Fp, Gs^Fp, Gs^Fp, Gg, Gg, Gg, Gg, Gg, Xu, Xu, Gg, Gg, Re, Re, Gg, Gg, Re, Re, Gg, Gg, Re, Re, Gg, Gg, Re, Re, Gg, Xu
Xu, Gg, Gg, Re, Re, Gg, Gg, Re, Re, Gg, Gg, Re, Re, Gg, Gg, Re, Xu, Xu, Gg, Gg, Gs^Fp, Gg, Gg, Gg, Gg, Gs^Fp, Gs^Fp, Gs^Fp, Gg, Gg, Gs^Fp, Gg, Gg, Gs^Fp, Gs^Fp, Gs^Fp, Gg, Gg, Gg, Gg, Gs^Fp, Gg, Gg, Xu, Xu, Gg, Gg, Re, Re, Gg, Gg, Re, Re, Gg, Gg, Re, Re, Gg, Gg, Re, Xu
Xu, Re, Re, Gg, Gg, Re, Re, Gg, Gg, Re, Re, Gg, Gg, Re, Xu, Xu, Ww, Gg, Gs^Fp, Gg, Gs^Fp, Gs^Fp, Gs^Fp, Gg, Gs^Fp, Gg, Ww, Ww, Gg, Ds, Hh, Ds, Gg, Ww, Ww, Gg, Gs^Fp, Gg, Gs^Fp, Gs^Fp, Gs^Fp, Gg, Gs^Fp, Gg, Ww, Xu, Xu, Gg, Gg, Re, Re, Gg, Gg, Re, Re, Gg, Gg, Re, Re, Gg, Xu
Xu, Gg, Gg, Re, Re, Gg, Gg, Re, Re, Gg, Gg, Re, Xu, Xu, Ww, Ww, Ww, Gs^Fp, Gs^Fp, Gs^Fp, Gs^Fp, Gs^Fp, Gs^Fp, Gg, Gg, Gg, Gs^Fp, Gs^Fp, Gs^Fp, Rr, Gg, Rr, Gs^Fp, Gs^Fp, Gs^Fp, Gg, Gg, Gg, Gs^Fp, Gs^Fp, Gs^Fp, Gs^Fp, Gs^Fp, Gs^Fp, Ww, Ww, Ww, Xu, Xu, Gg, Gg, Re, Re, Gg, Gg, Re, Re, Gg, Gg, Re, Xu
Xu, Re, Re, Gg, Gg, Re, Re, Gg, Gg, Re, Xu, Xu, Ww, Ww, Ww, Ww, Ww, Gs^Fp, Gs^Fp, Gs^Fp, Gs^Fp, Gs^Fp, Gg, Ss, Gs^Fp, Gs^Fp, Gs^Fp, Gs^Fp, Gs^Fp, Gg, Gs^Fp, Gg, Gs^Fp, Gs^Fp, Gs^Fp, Gs^Fp, Gs^Fp, Ss, Gg, Gs^Fp, Gs^Fp, Gs^Fp, Gs^Fp, Gs^Fp, Ww, Ww, Ww, Ww, Ww, Xu, Xu, Gg, Gg, Re, Re, Gg, Gg, Re, Re, Gg, Xu
Xu, Gg, Gg, Re, Re, Gg, Gg, Re, Xu, Xu, Gg, Gg, Gs^Fp, Gs^Fp, Gs^Fp, Gg, Ds, Ww, Ww, Ds, Ww, Gs^Fp, Gs^Fp, Gg, Gs^Fp, Gs^Fp, Gs^Fp, Gs^Fp, Gg, Gs^Fp, Gs^Fp, Gs^Fp, Gg, Gs^Fp, Gs^Fp, Gs^Fp, Gs^Fp, Gg, Gs^Fp, Gs^Fp, Ww, Ds, Ww, Ww, Ds, Gg, Gs^Fp, Gs^Fp, Gs^Fp, Gg, Gg, Xu, Xu, Gg, Gg, Re, Re, Gg, Gg, Re, Xu
Xu, Re, Re, Gg, Gg, Re, Xu, Xu, Gg, Gg, Hh, Gg, Gs^Fp, Gs^Fp, Gs^Fp, Gs^Fp, Gs^Fp, Gs^Fp, Gs^Fp, Ww, Ww, Gg, Gg, Gs^Fp, Gs^Fp, Gs^Fp, Gg, Gg, Mm, Gs^Fp, Gs^Fp, Gs^Fp, Mm, Gg, Gg, Gs^Fp, Gs^Fp, Gs^Fp, Gg, Gg, Ww, Ww, Gs^Fp, Gs^Fp, Gs^Fp, Gs^Fp, Gs^Fp, Gs^Fp, Gs^Fp, Gg, Hh, Gg, Gg, Xu, Xu, Gg, Gg, Re, Re, Gg, Xu
Xu, Gg, Gg, Re, Xu, Xu, Ds, Ss, Gg, Gg, Gs^Fp, Rr, Rr, Gs^Fp, Gg^Vh, Gs^Fp, Gs^Fp, Gs^Fp, Gs^Fp, Gg, Gg, Ww, Ww, Gg, Gg, Gs^Fp, Gg, Gg, Gg, Rr, Rr, Rr, Gg, Gg, Gg, Gs^Fp, Gg, Gg, Ww, Ww, Gg, Gg, Gs^Fp, Gs^Fp, Gs^Fp, Gs^Fp, Gg^Vh, Gs^Fp, Rr, Rr, Gs^Fp, Gg, Gg, Ss, Ds, Xu, Xu, Gg, Gg, Re, Xu
Xu, Re, Re, Xu, Ss, Ss, Chs, Ds, Gs^Fp, Gs^Fp, Gg, Gg, Gg, Rr, Rr, Gs^Fp, Gg, Gs^Fp, Gg, Gg, Chs, Gg, Gg, Ww, Ww, Gg, Ww, Gg, Gg, Gg, Uh, Gg, Gg, Gg, Ww, Gg, Ww, Ww, Gg, Gg, Chs, Gg, Gg, Gs^Fp, Gg, Gs^Fp, Rr, Rr, Gg, Gg, Gg, Gs^Fp, Gs^Fp, Ds, Chs, Ss, Ss, Xu, Re, Gg, Xu
Xu, Gg, Gg, Xu, Ss, Ss, Gg, Gg, Gg, Gs^Fp, Gg, Gg, Ss, Gg, Gg, Rr, Rr, Gg, Ww, Ss, Gg, Gg, Gs^Fp, Gs^Fp, Gs^Fp, Wo, Ww, Ww, Ds, Gg, Gg, Gg, Ds, Ww, Ww, Wo, Gs^Fp, Gs^Fp, Gs^Fp, Gg, Gg, Ss, Ww, Gg, Rr, Rr, Gg, Gg, Ss, Gg, Gg, Gs^Fp, Gg, Gg, Gg, Ss, Ss, Xu, Gg, Re, Xu
Xu, Re, Re, Xu, Ww, Gg, Gg, Gs^Fp, Gs^Fp, Gg, Gg, Ss, Ww, Ww, Gs^Fp, Gs^Fp, Hh, Rr, Rr, Gs^Fp, Gs^Fp, Gg, Gs^Fp, Gs^Fp, Gs^Fp, Ww, Gg, Ww, Ww, Ds, Ww, Ds, Ww, Ww, Gg, Ww, Gs^Fp, Gs^Fp, Gs^Fp, Gg, Gs^Fp, Gs^Fp, Rr, Rr, Hh, Gs^Fp, Gs^Fp, Ww, Ww, Ss, Gg, Gg, Gs^Fp, Gs^Fp, Gg, Gg, Ww, Xu, Re, Gg, Xu
Xu, Gg, Gg, Xu, Ww, Gg, Gs^Fp, Gs^Fp, Gs^Fp, Gs^Fp, Gs^Fp, Ds, Gs^Fp, Gs^Fp, Gs^Fp, Gs^Fp, Gg, Gg, Ss, Rr, Rr, Gs^Fp, Ch, Gs^Fp, Ch, Gg, Gs^Fp, Gs^Fp, Ds, Ww, Gg^Vh, Ww, Ds, Gs^Fp, Gs^Fp, Gg, Ch, Gs^Fp, Ch, Gs^Fp, Rr, Rr, Ss, Gg, Gg, Gs^Fp, Gs^Fp, Gs^Fp, Gs^Fp, Ds, Gs^Fp, Gs^Fp, Gs^Fp, Gs^Fp, Gs^Fp, Gg, Ww, Xu, Gg, Re, Xu
Xu, Re, Re, Xu, Ww, Ww, Gs^Fp, Gs^Fp, Gs^Fp, Gg, Gg, Gs^Fp, Gs^Fp, Gs^Fp, Gs^Fp, Gs^Fp, Gg, Ds, Ss, Ss, Ww, Rr, Ch, 1 Kh, Ch, Gs^Fp, Gs^Fp, Gs^Fp, Gs^Fp, Ww, Ww, Ww, Gs^Fp, Gs^Fp, Gs^Fp, Gs^Fp, Ch, 2 Kh, Ch, Rr, Ww, Ss, Ss, Ds, Gg, Gs^Fp, Gs^Fp, Gs^Fp, Gs^Fp, Gs^Fp, Gg, Gg, Gs^Fp, Gs^Fp, Gs^Fp, Ww, Ww, Xu, Re, Gg, Xu
Xu, Gg, Gg, Xu, Ww, Ww, Ww, Gs^Fp, Gg, Gs^Fp, Gg, Gg, Rr, Gs^Fp, Gs^Fp, Gs^Fp, Gg, Ds, Wwf, Wwf, Gg, Gg, Gs^Fp, Rr, Gg, Gg, Gg, Gs^Fp, Ww, Ww, Ds, Ww, Ww, Gs^Fp, Gg, Gg, Gg, Rr, Gs^Fp, Gg, Gg, Wwf, Wwf, Ds, Gg, Gs^Fp, Gs^Fp, Gs^Fp, Rr, Gg, Gg, Gs^Fp, Gg, Gs^Fp, Ww, Ww, Ww, Xu, Gg, Re, Xu
Xu, Re, Re, Xu, Ww, Ww, Gs^Fp, Ww, Ww, Gg, Gg, Hh, Gg, Gg, Gs^Fp, Gs^Fp, Gs^Fp, Gg, Gg, Gg, Gs^Fp, Gs^Fp, Rr, Rr, Gg, Gg, Ww, Ww, Gg, Gs^Fp, Gg, Gs^Fp, Gg, Ww, Ww, Gg, Gg, Rr, Rr, Gs^Fp, Gs^Fp, Gg, Gg, Gg, Gs^Fp, Gs^Fp, Gs^Fp, Gg, Gg, Hh, Gg, Gg, Ww, Ww, Gs^Fp, Ww, Ww, Xu, Re, Gg, Xu
Xu, Gg, Gg, Xu, Gg, Gs^Fp, Gs^Fp, Gs^Fp, Gg, Ww, Ww, Gg, Gg, Gg, Gs^Fp, Gs^Fp, Gg, Gg, Gs^Fp, Gg, Rr, Rr, Gg, Gg, Wo, Wo, Gs^Fp, Wwf, Ds, Gg, Gg, Gg, Ds, Wwf, Gs^Fp, Wo, Wo, Gg, Gg, Rr, Rr, Gg, Gs^Fp, Gg, Gg, Gs^Fp, Gs^Fp, Gg, Gg, Gg, Ww, Ww, Gg, Gs^Fp, Gs^Fp, Gs^Fp, Gg, Xu, Gg, Re, Xu
Xu, Re, Re, Xu, Ss, Gs^Fp, Gs^Fp, Gs^Fp, Gg, Ds, Ds, Ww, Wo, Ww, Ww, Gs^Fp, Gg, Gs^Fp, Uh, Rr, Gg, Gg, Ww, Ww, Gs^Fp, Gs^Fp, Hh, Gg, Mm, Gs^Fp, Gs^Fp, Gs^Fp, Mm, Gg, Hh, Gs^Fp, Gs^Fp, Ww, Ww, Gg, Gg, Rr, Uh, Gs^Fp, Gg, Gs^Fp, Ww, Ww, Wo, Ww, Ds, Ds, Gg, Gs^Fp, Gs^Fp, Gs^Fp, Ss, Xu, Re, Gg, Xu
Xu, Gg, Gg, Xu, Gg, Gg, Gg^Vh, Gg, Gg, Ww, Gg, Gg, Gg, Ww, Ww, Ds, Ds, Gg, Ds, Rr, Ww^Bw\, Ww, Gs^Fp, Ww, Gg, Gg, Rr, Rr, Ds, Gg, Gs^Fp, Gg, Ds, Rr, Rr, Gg, Gg, Ww, Gs^Fp, Ww, Ww^Bw/, Rr, Ds, Gg, Ds, Ds, Ww, Ww, Gg, Gg, Gg, Ww, Gg, Gg, Gg^Vh, Gg, Gg, Xu, Gg, Re, Xu
Xu, Re, Re, Xu, Gs^Fp, Gs^Fp, Gs^Fp, Ss, Ss, Rr, Wwf, Gg, Gs^Fp, Gs^Fp, Gs^Fp, Ww, Ww, Ww, Ww, Ww, Gg, Gg, Gs^Fp, Ds, Ss, Hh, Gg, Ds, Ss, Gs^Fp, Ww, Gs^Fp, Ss, Ds, Gg, Hh, Ss, Ds, Gs^Fp, Gg, Gg, Ww, Ww, Ww, Ww, Ww, Gs^Fp, Gs^Fp, Gs^Fp, Gg, Wwf, Rr, Ss, Ss, Gs^Fp, Gs^Fp, Gs^Fp, Xu, Re, Gg, Xu
Xu, Gg, Gg, Xu, Gs^Fp, Gs^Fp, Gs^Fp, Ss, Ss, Hh, Wwf, Uh, Gs^Fp, Hh, Gs^Fp, Ww, Ww, Gg^Vh, Ww, Wwf, Gg, Gs^Fp, Gs^Fp, Gs^Fp, Ss, Uh, Gg, Gs^Fp, Ss, Uh, Ww, Uh, Ss, Gs^Fp, Gg, Uh, Ss, Gs^Fp, Gs^Fp, Gs^Fp, Gg, Wwf, Ww, Gg^Vh, Ww, Ww, Gs^Fp, Hh, Gs^Fp, Uh, Wwf, Hh, Ss, Ss, Gs^Fp, Gs^Fp, Gs^Fp, Xu, Gg, Re, Xu
Xu, Re, Re, Xu, Gg, Gs^Fp, Gg^Vh, Ss, Gg, Rr, Gg, Gg, Gg, Gs^Fp, Ww, Ww, Ds, Ww, Ds, Ww, Ww^Bw/, Gg, Gs^Fp, Ds, Gg, Hh, Rr, Ds, Ds, Gs^Fp, Gs^Fp, Gs^Fp, Ds, Ds, Rr, Hh, Gg, Ds, Gs^Fp, Gg, Ww^Bw\, Ww, Ds, Ww, Ds, Ww, Ww, Gs^Fp, Gg, Gg, Gg, Rr, Gg, Ss, Gg^Vh, Gs^Fp, Gg, Xu, Re, Gg, Xu
Xu, Gg, Gg, Xu, Ss, Gg, Gs^Fp, Gg, Gg, Ww, Ds, Gg, Wo, Ww, Ww, Ds, Gg, Gg, Uh, Rr, Gg, Ww, Ww, Ww, Gs^Fp, Gg, Hh, Rr, Mm, Gg, Gs^Fp, Gg, Mm, Rr, Hh, Gg, Gs^Fp, Ww, Ww, Ww, Gg, Rr, Uh, Gg, Gg, Ds, Ww, Ww, Wo, Gg, Ds, Ww, Gg, Gg, Gs^Fp, Gg, Ss, Xu, Gg, Re, Xu
Xu, Re, Re, Xu, Gg, Gs^Fp, Gs^Fp, Gs^Fp, Gg, Ds, Ww, Ww, Gg, Ww, Gs^Fp, Gs^Fp, Gg, Gs^Fp, Gs^Fp, Rr, Rr, Gg, Gg, Ww, Wo, Gs^Fp, Gs^Fp, Gg, Ds, Gs^Fp, Gg, Gs^Fp, Ds, Gg, Gs^Fp, Gs^Fp, Wo, Ww, Gg, Gg, Rr, Rr, Gs^Fp, Gs^Fp, Gg, Gs^Fp, Gs^Fp, Ww, Gg, Ww, Ww, Ds, Gg, Gs^Fp, Gs^Fp, Gs^Fp, Gg, Xu, Re, Gg, Xu
Xu, Gg, Gg, Xu, Ww, Gs^Fp, Gs^Fp, Gs^Fp, Ww, Ww, Gg, Gg, Gg, Gg, Gs^Fp, Gs^Fp, Gs^Fp, Gg, Gg, Gg, Gs^Fp, Rr, Rr, Gg, Gg, Wo, Ww, Wwf, Gg, Gg, Gg, Gg, Gg, Wwf, Ww, Wo, Gg, Gg, Rr, Rr, Gs^Fp, Gg, Gg, Gg, Gs^Fp, Gs^Fp, Gs^Fp, Gg, Gg, Gg, Gg, Ww, Ww, Gs^Fp, Gs^Fp, Gs^Fp, Ww, Xu, Gg, Re, Xu
Xu, Re, Re, Xu, Ww, Ww, Ww, Ww, Gg, Gg, Gg, Hh, Rr, Gg, Gs^Fp, Gs^Fp, Gg, Gg, Wwf, Gg, Gg, Gs^Fp, Gs^Fp, Rr, Gg, Gg, Gg, Ww, Ww, Gs^Fp, Ds, Gs^Fp, Ww, Ww, Gg, Gg, Gg, Rr, Gs^Fp, Gs^Fp, Gg, Gg, Wwf, Gg, Gg, Gs^Fp, Gs^Fp, Gg, Rr, Hh, Gg, Gg, Gg, Ww, Ww, Ww, Ww, Xu, Re, Gg, Xu
Xu, Gg, Gg, Xu, Ww, Ww, Gs^Fp, Gs^Fp, Gs^Fp, Gs^Fp, Gg, Gg, Gs^Fp, Gs^Fp, Gs^Fp, Gs^Fp, Gg, Ds, Ss, Wwf, Ww, Gg, Ch, Rr, Ch, Gg, Gs^Fp, Gs^Fp, Gs^Fp, Ww, Ww, Ww, Gs^Fp, Gs^Fp, Gs^Fp, Gg, Ch, Rr, Ch, Gg, Ww, Wwf, Ss, Ds, Gg, Gs^Fp, Gs^Fp, Gs^Fp, Gs^Fp, Gg, Gg, Gs^Fp, Gs^Fp, Gs^Fp, Gs^Fp, Ww, Ww, Xu, Gg, Re, Xu
Xu, Re, Re, Xu, Ww, Ww, Gs^Fp, Gs^Fp, Gs^Fp, Gg, Gs^Fp, Gs^Fp, Gs^Fp, Gs^Fp, Gs^Fp, Gs^Fp, Gg, Ds, Ss, Ss, Rr, Rr, Ch, 3 Kh, Ch, Gs^Fp, Gs^Fp, Gs^Fp, Ds, Ww, Gg^Vh, Ww, Ds, Gs^Fp, Gs^Fp, Gs^Fp, Ch, 4 Kh, Ch, Rr, Rr, Ss, Ss, Ds, Gg, Gs^Fp, Gs^Fp, Gs^Fp, Gs^Fp, Gs^Fp, Gs^Fp, Gg, Gs^Fp, Gs^Fp, Gs^Fp, Ww, Ww, Xu, Re, Gg, Xu
Xu, Gg, Gg, Xu, Ww, Gg, Gg, Gs^Fp, Gs^Fp, Gs^Fp, Gg, Ds, Ww, Gs^Fp, Gs^Fp, Gs^Fp, Hh, Gg, Rr, Rr, Gs^Fp, Gs^Fp, Gs^Fp, Gs^Fp, Gs^Fp, Gg, Gg, Gs^Fp, Ww, Ww, Ww, Ww, Ww, Gs^Fp, Gg, Gg, Gs^Fp, Gs^Fp, Gs^Fp, Gs^Fp, Gs^Fp, Rr, Rr, Gg, Hh, Gs^Fp, Gs^Fp, Gs^Fp, Ww, Ds, Gg, Gs^Fp, Gs^Fp, Gs^Fp, Gg, Gg, Ww, Xu, Gg, Re, Xu
Xu, Re, Re, Xu, Ss, Gg, Gg, Gs^Fp, Gg, Gg, Gg, Ss, Ss, Ww, Gg, Gs^Fp, Rr, Rr, Ww, Gs^Fp, Gg, Gg, Gs^Fp, Gs^Fp, Gs^Fp, Ww, Ww, Ww, Ds, Ds, Gg, Ds, Ds, Ww, Ww, Ww, Gs^Fp, Gs^Fp, Gs^Fp, Gg, Gg, Gs^Fp, Ww, Rr, Rr, Gs^Fp, Gg, Ww, Ss, Ss, Gg, Gg, Gg, Gs^Fp, Gg, Gg, Ss, Xu, Re, Gg, Xu
Xu, Gg, Gg, Xu, Ss, Ss, Chs, Gg, Gs^Fp, Gs^Fp, Gg, Gg, Gg, Gg, Rr, Rr, Gg, Gg, Gg, Ss, Chs, Gg, Gg, Gs^Fp, Ww, Wo, Ww, Ww, Gg, Gg, Uh, Gg, Gg, Ww, Ww, Wo, Ww, Gs^Fp, Gg, Gg, Chs, Ss, Gg, Gg, Gg, Rr, Rr, Gg, Gg, Gg, Gg, Gs^Fp, Gs^Fp, Gg, Chs, Ss, Ss, Xu, Gg, Re, Xu
Xu, Re, Re, Xu, Xu, Ss, Ds, Ds, Gg, Gs^Fp, Gs^Fp, Gg, Rr, Rr, Gg^Vh, Gs^Fp, Gs^Fp, Gs^Fp, Gs^Fp, Gg, Gg, Gg, Ww, Ww, Gg, Gg, Gg, Gg, Gg, Gg, Rr, Gg, Gg, Gg, Gg, Gg, Gg, Ww, Ww, Gg, Gg, Gg, Gs^Fp, Gs^Fp, Gs^Fp, Gs^Fp, Gg^Vh, Rr, Rr, Gg, Gs^Fp, Gs^Fp, Gg, Ds, Ds, Ss, Xu, Xu, Re, Gg, Xu
Xu, Gg, Gg, Re, Re, Xu, Xu, Ss, Gg, Gg, Hh, Rr, Gs^Fp, Gs^Fp, Gs^Fp, Gs^Fp, Gs^Fp, Gs^Fp, Gs^Fp, Gg, Ww, Ww, Gg, Gg, Gs^Fp, Gs^Fp, Gg, Gg, Mm, Rr, Gs^Fp, Rr, Mm, Gg, Gg, Gs^Fp, Gs^Fp, Gg, Gg, Ww, Ww, Gg, Gs^Fp, Gs^Fp, Gs^Fp, Gs^Fp, Gs^Fp, Gs^Fp, Gs^Fp, Rr, Hh, Gg, Gg, Ss, Xu, Xu, Re, Gg, Gg, Re, Xu
Xu, Re, Re, Gg, Gg, Re, Re, Xu, Xu, Gg, Gg, Gg, Gs^Fp, Gs^Fp, Gs^Fp, Gs^Fp, Ds, Gs^Fp, Ww, Ww, Ww, Gg, Gs^Fp, Gs^Fp, Gs^Fp, Gs^Fp, Gs^Fp, Gg, Gg, Gs^Fp, Gs^Fp, Gs^Fp, Gg, Gg, Gs^Fp, Gs^Fp, Gs^Fp, Gs^Fp, Gs^Fp, Gg, Ww, Ww, Ww, Gs^Fp, Ds, Gs^Fp, Gs^Fp, Gs^Fp, Gs^Fp, Gg, Gg, Gg, Xu, Xu, Re, Gg, Gg, Re, Re, Gg, Xu
Xu, Gg, Gg, Re, Re, Gg, Gg, Re, Re, Xu, Xu, Gg, Ww, Gs^Fp, Ww, Gg, Ww, Ww, Gs^Fp, Ds, Gs^Fp, Gs^Fp, Gg, Gg, Gs^Fp, Gs^Fp, Gs^Fp, Gs^Fp, Gs^Fp, Gs^Fp, Gs^Fp, Gs^Fp, Gs^Fp, Gs^Fp, Gs^Fp, Gs^Fp, Gs^Fp, Gg, Gg, Gs^Fp, Gs^Fp, Ds, Gs^Fp, Ww, Ww, Gg, Ww, Gs^Fp, Ww, Gg, Xu, Xu, Re, Gg, Gg, Re, Re, Gg, Gg, Re, Xu
Xu, Re, Re, Gg, Gg, Re, Re, Gg, Gg, Re, Re, Xu, Xu, Ww, Ww, Ww, Ww, Gs^Fp, Gs^Fp, Gs^Fp, Gs^Fp, Gs^Fp, Gs^Fp, Ss, Gg, Gs^Fp, Gs^Fp, Gs^Fp, Gs^Fp, Gg, Gg, Gg, Gs^Fp, Gs^Fp, Gs^Fp, Gs^Fp, Gg, Ss, Gs^Fp, Gs^Fp, Gs^Fp, Gs^Fp, Gs^Fp, Gs^Fp, Ww, Ww, Ww, Ww, Xu, Xu, Re, Gg, Gg, Re, Re, Gg, Gg, Re, Re, Gg, Xu
Xu, Gg, Gg, Re, Re, Gg, Gg, Re, Re, Gg, Gg, Re, Re, Xu, Xu, Ww, Ww, Gs^Fp, Gs^Fp, Gs^Fp, Gs^Fp, Gs^Fp, Gs^Fp, Gg, Gs^Fp, Gg, Ww, Gs^Fp, Gg, Rr, Hh, Rr, Gg, Gs^Fp, Ww, Gg, Gs^Fp, Gg, Gs^Fp, Gs^Fp, Gs^Fp, Gs^Fp, Gs^Fp, Gs^Fp, Ww, Ww, Xu, Xu, Re, Gg, Gg, Re, Re, Gg, Gg, Re, Re, Gg, Gg, Re, Xu
Xu, Re, Re, Gg, Gg, Re, Re, Gg, Gg, Re, Re, Gg, Gg, Re, Re, Xu, Xu, Gg, Gg, Gg, Gs^Fp, Gs^Fp, Gg, Gg, Gg, Gg, Gs^Fp, Ww, Gg, Ds, Gs^Fp, Ds, Gg, Ww, Gs^Fp, Gg, Gg, Gg, Gg, Gs^Fp, Gs^Fp, Gg, Gg, Gg, Xu, Xu, Re, Gg, Gg, Re, Re, Gg, Gg, Re, Re, Gg, Gg, Re, Re, Gg, Xu
Xu, Gg, Gg, Re, Re, Gg, Gg, Re, Re, Gg, Gg, Re, Re, Gg, Gg, Re, Re, Xu, Xu, Gg, Gg, Gg, Gg, Gg, Gg, Gs^Fp, Gs^Fp, Gs^Fp, Gg, Gg, Gs^Fp, Gg, Gg, Gs^Fp, Gs^Fp, Gs^Fp, Gg, Gg, Gg, Gg, Gg, Gg, Xu, Xu, Re, Gg, Gg, Re, Re, Gg, Gg, Re, Re, Gg, Gg, Re, Re, Gg, Gg, Re, Xu
Xu, Re, Re, Gg, Gg, Re, Re, Gg, Gg, Re, Re, Gg, Gg, Re, Re, Gg, Gg, Re, Re, Xu, Xu, Gg, Ss, Gg, Rr, Gs^Fp, Gs^Fp, Gs^Fp, Gg, Gg, Uh, Gg, Gg, Gs^Fp, Gs^Fp, Gs^Fp, Rr, Gg, Ss, Gg, Xu, Xu, Re, Gg, Gg, Re, Re, Gg, Gg, Re, Re, Gg, Gg, Re, Re, Gg, Gg, Re, Re, Gg, Xu
Xu, Gg, Gg, Re, Re, Gg, Gg, Re, Re, Gg, Gg, Re, Re, Gg, Gg, Re, Re, Gg, Gg, Re, Re, Xu, Xu, Gg, Gg, Hh, Gg, Gg, Chs, Gg, Gg, Gg, Chs, Gg, Gg, Hh, Gg, Gg, Xu, Xu, Re, Gg, Gg, Re, Re, Gg, Gg, Re, Re, Gg, Gg, Re, Re, Gg, Gg, Re, Re, Gg, Gg, Re, Xu
Xu, Re, Re, Gg, Gg, Re, Re, Gg, Gg, Re, Re, Gg, Gg, Re, Re, Gg, Gg, Re, Re, Gg, Gg, Re, Re, Xu, Xu, Ds, Ds, Chs, Gg, Gg, Gg^Vh, Gg, Gg, Chs, Ds, Ds, Xu, Xu, Re, Gg, Gg, Re, Re, Gg, Gg, Re, Re, Gg, Gg, Re, Re, Gg, Gg, Re, Re, Gg, Gg, Re, Re, Gg, Xu
Xu, Gg, Gg, Re, Re, Gg, Gg, Re, Re, Gg, Gg, Re, Re, Gg, Gg, Re, Re, Gg, Gg, Re, Re, Gg, Gg, Re, Re, Xu, Xu, Ss, Ss, Gg, Ss, Gg, Ss, Ss, Xu, Xu, Re, Gg, Gg, Re, Re, Gg, Gg, Re, Re, Gg, Gg, Re, Re, Gg, Gg, Re, Re, Gg, Gg, Re, Re, Gg, Gg, Re, Xu
Xu, Re, Re, Gg, Gg, Re, Re, Gg, Gg, Re, Re, Gg, Gg, Re, Re, Gg, Gg, Re, Re, Gg, Gg, Re, Re, Gg, Gg, Re, Re, Xu, Xu, Ss, Qxu, Ss, Xu, Xu, Re, Gg, Gg, Re, Re, Gg, Gg, Re, Re, Gg, Gg, Re, Re, Gg, Gg, Re, Re, Gg, Gg, Re, Re, Gg, Gg, Re, Re, Gg, Xu
Xu, Gg, Gg, Re, Re, Gg, Gg, Re, Re, Gg, Gg, Re, Re, Gg, Gg, Re, Re, Gg, Gg, Re, Re, Gg, Gg, Re, Re, Gg, Gg, Re, Re, Xu, Xu, Xu, Re, Gg, Gg, Re, Re, Gg, Gg, Re, Re, Gg, Gg, Re, Re, Gg, Gg, Re, Re, Gg, Gg, Re, Re, Gg, Gg, Re, Re, Gg, Gg, Re, Xu
Xu, Re, Re, Gg, Gg, Re, Re, Gg, Gg, Re, Re, Gg, Gg, Re, Re, Gg, Gg, Re, Re, Gg, Gg, Re, Re, Gg, Gg, Re, Re, Gg, Gg, Re, Re, Gg, Gg, Re, Re, Gg, Gg, Re, Re, Gg, Gg, Re, Re, Gg, Gg, Re, Re, Gg, Gg, Re, Re, Gg, Gg, Re, Re, Gg, Gg, Re, Re, Gg, Xu
Xu, Gg, Gg, Re, Re, Gg, Gg, Re, Re, Gg, Gg, Re, Re, Gg, Gg, Re, Re, Gg, Gg, Re, Re, Gg, Gg, Re, Re, Gg, Gg, Re, Re, Gg, Gg, Re, Re, Gg, Gg, Re, Re, Gg, Gg, Re, Re, Gg, Gg, Re, Re, Gg, Gg, Re, Re, Gg, Gg, Re, Re, Gg, Gg, Re, Re, Gg, Gg, Re, Xu
Xu, Xu, Xu, Xu, Xu, Xu, Xu, Xu, Xu, Xu, Xu, Xu, Xu, Xu, Xu, Xu, Xu, Xu, Xu, Xu, Xu, Xu, Xu, Xu, Xu, Xu, Xu, Xu, Xu, Xu, Xu, Xu, Xu, Xu, Xu, Xu, Xu, Xu, Xu, Xu, Xu, Xu, Xu, Xu, Xu, Xu, Xu, Xu, Xu, Xu, Xu, Xu, Xu, Xu, Xu, Xu, Xu, Xu, Xu, Xu, Xu
