Xu, Xu, Xu, Xu, Xu, Xu, Xu, Xu, Xu, Xu, Xu, Xu, Xu, Xu, Xu, Xu, Xu, Xu, Xu, Xu, Xu, Xu, Xu, Xu, Xu, Xu, Xu, Xu, Xu, Xu, Xu, Xu, Xu, Xu, Xu, Xu, Xu, Xu, Xu, Xu, Xu
Xu, Xu, Xu, Xu, Xu, Xu, Xu, Xu, Xu, Xu, Xu, Xu, Xu, Xu, Xu, Xu, Xu, Xu, Xu, Xu, Xu, Xu, Xu, Xu, Xu, Xu, Xu, Xu, Xu, Xu, Xu, Xu, Xu, Xu, Xu, Xu, Xu, Xu, Xu, Xu, Xu
Xu, Xu, Xu, Xu, Xu, Xu, Xu, Xu, Xu, Xu, Xu, Xu, Xu, Xu, Xu, Xu, Xu, Xu, Xu, Xu, Xu, Xu, Xu, Xu, Xu, Xu, Xu, Xu, Xu, Xu, Xu, Xu, Xu, Xu, Xu, Xu, Xu, Xu, Xu, Xu, Xu
Xu, Xu, Xu, Xu, Xu, Xu, Xu, Xu, Xu, Xu, Xu, Xu, Uu, Xu, Xu, Xu, Xu, Xu, Xu, Xu, Xu, Xu, Xu, Xu, Xu, Xu, Xu, Xu, Xu, Xu, Xu, Xu, Xu, Xu, Xu, Xu, Xu, Xu, Xu, Xu, Xu
Xu, Xu, Xu, Xu, Xu, Xu, Xu, Xu, Xu, Xu, Xu, Xu, Qxu, Xu, Xu, Xu, Xu, Xu, Xu, Xu, Xu, Xu, Xu, Xu, Xu, Xu, Xu, Xu, Xu, Xu, Xu, Xu, Xu, Xu, Xu, Xu, Xu, Xu, Xu, Xu, Xu
Xu, Xu, Xu, Xu, Xu, Xu, Xu, Xu, Xu, Xu, Xu, Xu, Qxu, Xu, Xu, Xu, Xu, Xu, Xu, Xu, Xu, Xu, Uu^Uf, Xu, Uh, Xu, Xu, Xu, Xu, Xu, Xu, Xu, Xu, Xu, Xu, Xu, Xu, Xu, Xu, Xu, Xu
Xu, Xu, Xu, Xu, Xu, Xu, Xu, Xu, Xu, Xu, Xu, Qxu, Rr, Qxu, Qxu, Xu, Xu, Xu, Xu, Xu, Xu, Xu, Uu, Uu, Rr, Uu, Xu, Xu, Xu, Xu, Xu, Xu, Xu, Xu, Xu, Xu, Xu, Xu, Xu, Xu, Xu
Xu, Xu, Xu, Xu, Xu, Xu, Xu, Xu, Xu, Xu, Uu, Rr, Xu, Rr, Rr, Qxu, Xu, Xu, Xu, Xu, Xu, Xu, Xu, Rr, Rr, Rr, Xu, Xu, Xu, Xu, Xu, Xu, Xu, Xu, Xu, Xu, Xu, Xu, Xu, Xu, Ww
Xu, Xu, Xu, Xu, Xu, Xu, Xu, Xu, Xu, Xu, Xu, Xu, Gs^Fp, Xu, Xu, Rr, Xu, Xu, Xu, Xu, Xu, Xu, Uu^Ii, Rr, Xu, Xu, Xu, Xu, Gs^Fp, Xu, Xu, Xu, Xu, Xu, Xu, Xu, Xu, Xu, Ww, Ww, Xu
Xu, Xu, Xu, Xu, Xu, Xu, Xu, Xu, Xu, Xu, Gs^Fp, Gs^Fp, Gs^Fp, Gs^Fp, Gs^Fp, Rr, Xu, Xu, Xu, Xu, Xu, Xu, Rr, Xu, Xu, Xu, Gs^Fp, Gs^Fp, Gs^Fp, Gs^Fp, Wwf, Xu, Xu, Xu, Xu, Xu, Ww, Ww, Xu, Xu, Xu
Xu, Xu, Xu, Xu, Xu, Xu, Xu, Xu, Gs^Fp, Gs^Fp, Gs^Fp, Gs^Fp, Gg, Gs^Fp, Gs^Fp, Gs^Fp, Gs^Fp, Xu, Xu, Xu, Xu, Xu, Rr, Xu, Gs^Fp, Gs^Fp, Gs^Fp, Gs^Fp, Ww, Gs^Fp, Gs^Fp, Gs^Fp, Gs^Fp, Xu, Ww, Ww, Xu, Xu, Xu, Xu, Xu
Xu, Xu, 5 Kud, Xu, Xu, Xu, Gs^Fp, Gs^Fp, Gs^Fp, Ww, Ww, Mm, Gs^Fp, Gg, Ww, Ww, Gs^Fp, Gs^Fp, Ss, Gs^Fp, Xu, Gs^Fp, Gs^Fp, Gs^Fp, Mm, Gg, Gs^Fp, Ss, Ss, Gs^Fp, Gs^Fp, Gs^Fp, Ww, Ww, Gs^Fp, Xu, Xu, Xu, 6 Kud, Xu, Xu
Xu, Xu, Cud, Cud, Gs^Fp, Gs^Fp, Gs^Fp, Gs^Fp, Gs^Fp, Ss, Gs^Fp, Gs^Fp, Gs^Fp, Gs^Fp, Gs^Fp, Ww, Gs^Fp, Gs^Fp, Gs^Fp, Gs^Fp, Xu, Gs^Fp, Gs^Fp, Gs^Fp, Ww, Gg, Gs^Fp, Ss, Gs^Fp, Gs^Fp, Hh, Ww, Ww, Gs^Fp, Gs^Fp, Gs^Fp, Gs^Fp, Cud, Cud, Xu, Xu
Xu, Xu, Gs^Fp, Gs^Fp, Gg, Gs^Fp, Gs^Fp, Gs^Fp, Gg, Gs^Fp, Gs^Fp, Gg, Gg, Gs^Fp, Gs^Fp, Gs^Fp, Gs^Fp, Gs^Fp, Gs^Fp, Gg, Xu, Gs^Fp, Gs^Fp, Gs^Fp, Gs^Fp, Gs^Fp, Gs^Fp, Gs^Fp, Gs^Fp, Gg, Wwf, Ww, Ww, Gs^Fp, Gs^Fp, Gs^Fp, Gg, Gs^Fp, Gs^Fp, Xu, Xu
Gs^Fp, Gs^Fp, Gs^Fp, Gs^Fp, Gg, Gs^Fp, Mm, Gs^Fp, Gs^Fp, Gs^Fp, Gs^Fp, Gg, Gs^Fp, Gs^Fp, Gs^Fp, Gs^Fp, Gs^Fp, Gs^Fp, Gg, Gs^Fp, Xu, Hh, Gs^Fp, Gs^Fp, Gs^Fp, Gs^Fp, Gs^Fp, Gs^Fp, Wo, Wo, Gs^Fp, Gs^Fp, Gs^Fp, Wwf, Wo, Gg, Gs^Fp, Gs^Fp, Gs^Fp, Gs^Fp, Gs^Fp
Gs^Fp, Gs^Fp, Gs^Fp, Ww, Gs^Fp, Gs^Fp, Gg, Gs^Fp, Gg, Gs^Fp, Ww, Gg, Gs^Fp, Gs^Fp, Gg, Ww, Gs^Fp, Mm, Gs^Fp, Gs^Fp, Xu, Gg, Gs^Fp, Gs^Fp, Gs^Fp, Gs^Fp, Gs^Fp, Ww, Gs^Fp, Gs^Fp, Gg, Gs^Fp, Gg, Gs^Fp, Gs^Fp, Gs^Fp, Gs^Fp, Gs^Fp, Ss, Gs^Fp, Gs^Fp
Gs^Fp, Gs^Fp, Gs^Fp, Ww, Gs^Fp, Gg, Gs^Fp, Gs^Fp, Gg, Hh, Ww, Gs^Fp, Gs^Fp, Hh, Ss, Ss, Gs^Fp, Gs^Fp, Gg, Gs^Fp, Xu, Gs^Fp, Gs^Fp, Gg, Gs^Fp, Gs^Fp, Ss, Ww, Gs^Fp, Gs^Fp, Gs^Fp, Hh, Gs^Fp, Gs^Fp, Mm, Gg, Gs^Fp, Ss, Gs^Fp, Gs^Fp, Gs^Fp
Gs^Fp, Gs^Fp, Gg^Vh, Ss, Gs^Fp, Gs^Fp, Gs^Fp, Gs^Fp, Gs^Fp, Gs^Fp, Gs^Fp, Gs^Fp, Ww, Gs^Fp, Gs^Fp, Gs^Fp, Wwf, Gs^Fp, Ww, Gs^Fp, Xu, Ss, Gs^Fp, Mm, Gg, Hh, Gs^Fp, Ww, Wwf, Gg^Vh, Gg, Gs^Fp, Gs^Fp, Gs^Fp, Gs^Fp, Gg, Ss, Gs^Fp, Gs^Fp, Gs^Fp, Gs^Fp
Gs^Fp, Gs^Fp, Gs^Fp, Gs^Fp, Gs^Fp, Ww, Ww, Gs^Fp, Wo, Wo, Ww, Gs^Fp, Ww, Gs^Fp, Wwf, Gs^Fp, Ww, Gs^Fp, Gs^Fp, Gs^Fp, Xu, Gs^Fp, Gs^Fp, Ss, Gs^Fp, Gs^Fp, Wo, Ww, Ww, Gs^Fp, Wo, Mm, Gg, Gs^Fp, Gs^Fp, Gs^Fp, Gs^Fp, Gs^Fp, Ss, Gs^Fp, Gs^Fp
Gs^Fp, Gs^Fp, Mm, Gs^Fp, Gs^Fp, Gs^Fp, Ww, Ww, Ww, Ww, Ww, Ww, Ww, Ww, Ww, Ww, Ww, Ww, Ww, Gs^Fp, Xu, Gs^Fp, Ww, Ww, Ww, Ww, Ww, Ww, Ww, Ww, Ww, Ww, Gs^Fp, Gs^Fp, Ww, Gs^Fp, Gs^Fp, Gs^Fp, Gs^Fp, Gs^Fp, Gs^Fp
Gs^Fp, Gs^Fp, Gs^Fp, Gs^Fp, Hh, Wwf, Ww, Ww, Gs^Fp, Ww, 4 Kh, Wwf, Gs^Fp, Ww, Wo, Ww, Ww, Gs^Fp, Gg, Ww, Xu, Ww, Gs^Fp, Gs^Fp, Ch, Gg^Vhc, Rr, Gs^Fp, Gg, Ww, Ww, Ww, Ww, Ss, Hh, Wwf, Gs^Fp, Gs^Fp, Gs^Fp, Gs^Fp, Gs^Fp
Ww, Gs^Fp, Ww, Gg, Ww, Ww, Ww, Gs^Fp, Gg^Vhc, Ch, Rr, Ch, Gs^Fp, Wwf, Hh, Ww, Ww, Wo, Gs^Fp, Ww, Xu, Ww, Gs^Fp, Gg, 2 Kh, Rr, Gg, Rr, Rr, Wwf, Gg, Wo, Ww, Ww, Ww, Gs^Fp, Ww, Wo, Wo, Gs^Fp, Ww
Ww, Ww, Wo, Ww, Ww, Wo, Ww, Ww, Ww, Hh, Gg, Rr, Rr, Rp, Gg, Ch, 1 Kh, Ww, Gs^Fp, Ww, Xu, Ww, Gs^Fp, Ww, Ww, Ch, Hh, Rp, Gs^Fp, Rr, Rr, Hh, Gg^Vhc, Ww, Ww, Wo, Ww, Ww, Ww, Ww, Ww
Gs^Fp, Gs^Fp, Gs^Fp, Wo, Gs^Fp, Gs^Fp, Hh, Ww, Ww, Wo, Ww, Wwf, Gg, Rr, Rr, Rr, Ch, Gg, Gs^Fp, Ww, Xu, Ww, Gg, Wo, Ww, Ww, Wo, Wwf, Gs^Fp, Ch, 3 Kh, Ch, Gs^Fp, Gs^Fp, Ww, Ww, Hh, Gg, Gs^Fp, Gs^Fp, Gs^Fp
Gs^Fp, Gs^Fp, Gs^Fp, Gs^Fp, Gs^Fp, Ww, Wwf, Ss, Gs^Fp, Ww, Ww, Ww, Ww, Gs^Fp, Ww, Gg^Vhc, Ww, Gs^Fp, Ww, Ww, Xu, Ww, Ww, Gs^Fp, Ww, Ww, Ww, Ww, Ww, Wwf, Ww, Ww, Ww, Ww, Ww, Wwf, Gs^Fp, Gs^Fp, Mm, Gs^Fp, Gs^Fp
Gs^Fp, Gs^Fp, Ss, Gs^Fp, Gs^Fp, Gs^Fp, Gs^Fp, Gs^Fp, Gg, Ww, Wo, Ww, Ww, Ww, Wo, Ww, Gs^Fp, Ww, Gs^Fp, Gs^Fp, Xu, Gs^Fp, Gs^Fp, Ww, Ww, Ww, Wwf, Ww, Ww, Ww, Ww, Ww, Wo, Ww, Ww, Gs^Fp, Gs^Fp, Gs^Fp, Gs^Fp, Gs^Fp, Gs^Fp
Gs^Fp, Gs^Fp, Gs^Fp, Gs^Fp, Ss, Gs^Fp, Gs^Fp, Gs^Fp, Gs^Fp, Mm, Gg, Gs^Fp, Wwf, Ww, Gs^Fp, Gs^Fp, Gg, Ss, Gs^Fp, Gs^Fp, Xu, Gs^Fp, Ww, Gs^Fp, Wwf, Gs^Fp, Gs^Fp, Gs^Fp, Ww, Gs^Fp, Gs^Fp, Wo, Gs^Fp, Gs^Fp, Gs^Fp, Ww, Gs^Fp, Gs^Fp, Gg^Vh, Gs^Fp, Gs^Fp
Gs^Fp, Gs^Fp, Gs^Fp, Gs^Fp, Gs^Fp, Gg, Mm, Gs^Fp, Gs^Fp, Gs^Fp, Gs^Fp, Gg^Vh, Gs^Fp, Ww, Ss, Hh, Gs^Fp, Mm, Gs^Fp, Ss, Xu, Gs^Fp, Gg, Gs^Fp, Gs^Fp, Gs^Fp, Ss, Gs^Fp, Gs^Fp, Gs^Fp, Ww, Gs^Fp, Gg, Gs^Fp, Gs^Fp, Gs^Fp, Gs^Fp, Ss, Gs^Fp, Gs^Fp, Gs^Fp
Gs^Fp, Gs^Fp, Ss, Ss, Gs^Fp, Gg, Gs^Fp, Gs^Fp, Gg, Hh, Gg, Gs^Fp, Gs^Fp, Ww, Gs^Fp, Gs^Fp, Gs^Fp, Gg, Gs^Fp, Gs^Fp, Xu, Gs^Fp, Gs^Fp, Gs^Fp, Gs^Fp, Ss, Gg, Hh, Gs^Fp, Gs^Fp, Ww, Hh, Gg, Gs^Fp, Gg, Gg, Gs^Fp, Ww, Gs^Fp, Gs^Fp, Gs^Fp
Gs^Fp, Gs^Fp, Gs^Fp, Gs^Fp, Gs^Fp, Gs^Fp, Wo, Gs^Fp, Gs^Fp, Gs^Fp, Gs^Fp, Gs^Fp, Wo, Ww, Gs^Fp, Gs^Fp, Gs^Fp, Gs^Fp, Gs^Fp, Gg, Xu, Gs^Fp, Gg, Mm, Gs^Fp, Ww, Gs^Fp, Gs^Fp, Gg, Gg, Gs^Fp, Gs^Fp, Gs^Fp, Gs^Fp, Mm, Gs^Fp, Gg, Ww, Gs^Fp, Gs^Fp, Gs^Fp
Xu, Gs^Fp, Gs^Fp, Gs^Fp, Gg, Gg, Gs^Fp, Wwf, Ww, Gs^Fp, Wwf, Wo, Gs^Fp, Gs^Fp, Gs^Fp, Gs^Fp, Gs^Fp, Gs^Fp, Gs^Fp, Hh, Xu, Gs^Fp, Gs^Fp, Gs^Fp, Gs^Fp, Gs^Fp, Gs^Fp, Gs^Fp, Gs^Fp, Gg, Gs^Fp, Gs^Fp, Gg, Gs^Fp, Gs^Fp, Gs^Fp, Gg, Gs^Fp, Gs^Fp, Gs^Fp, Xu
Xu, Xu, Cud, Gs^Fp, Gs^Fp, Gs^Fp, Gs^Fp, Gs^Fp, Ww, Ww, Hh, Gg, Gs^Fp, Gs^Fp, Gs^Fp, Gs^Fp, Ww, Gs^Fp, Gs^Fp, Gs^Fp, Xu, Gg, Gs^Fp, Gs^Fp, Gs^Fp, Gs^Fp, Gs^Fp, Gs^Fp, Gs^Fp, Gg, Gs^Fp, Gs^Fp, Gs^Fp, Gs^Fp, Gs^Fp, Gs^Fp, Gs^Fp, Gs^Fp, Cud, Xu, Xu
Xu, Xu, 7 Kud, Cud, Xu, Gs^Fp, Gs^Fp, Gs^Fp, Ww, Ww, Gs^Fp, Gs^Fp, Ss, Ss, Gs^Fp, Gg, Mm, Gs^Fp, Gs^Fp, Gs^Fp, Xu, Gs^Fp, Ss, Gs^Fp, Gs^Fp, Ww, Ww, Gs^Fp, Gs^Fp, Gs^Fp, Ww, Ss, Gs^Fp, Gs^Fp, Gs^Fp, Gs^Fp, Xu, Cud, 8 Kud, Xu, Xu
Xu, Xu, Xu, Xu, Xu, Xu, Ww, Ww, Gs^Fp, Gs^Fp, Gs^Fp, Gs^Fp, Ww, Ss, Gs^Fp, Gg, Gs^Fp, Gs^Fp, Rr, Gs^Fp, Xu, Gs^Fp, Xu, Gs^Fp, Gs^Fp, Ww, Gs^Fp, Gg, Gg, Mm, Gs^Fp, Ww, Gs^Fp, Gs^Fp, Xu, Xu, Xu, Xu, Xu, Xu, Xu
Xu, Xu, Xu, Xu, Ww, Ww, Xu, Xu, Xu, Gs^Fp, Wwf, Gs^Fp, Gs^Fp, Gs^Fp, Gs^Fp, Gs^Fp, Xu, Xu, Rr, Xu, Xu, Xu, Xu, Xu, Xu, Gs^Fp, Gs^Fp, Gs^Fp, Gs^Fp, Gs^Fp, Gs^Fp, Gs^Fp, Xu, Xu, Xu, Xu, Xu, Xu, Xu, Xu, Xu
Xu, Xu, Ww, Ww, Xu, Xu, Xu, Xu, Xu, Xu, Xu, Gs^Fp, Gs^Fp, Gs^Fp, Xu, Xu, Xu, Xu, Uu^Ii, Xu, Xu, Xu, Xu, Xu, Xu, Rr, Xu, Gs^Fp, Gs^Fp, Gs^Fp, Xu, Xu, Xu, Xu, Xu, Xu, Xu, Xu, Xu, Xu, Xu
Ww, Ww, Xu, Xu, Xu, Xu, Xu, Xu, Xu, Xu, Xu, Xu, Xu, Xu, Xu, Xu, Rr, Rr, Xu, Xu, Xu, Xu, Xu, Xu, Qxu, Rr, Rr, Xu, Xu, Xu, Uu, Xu, Xu, Xu, Xu, Xu, Xu, Xu, Xu, Xu, Xu
Xu, Xu, Xu, Xu, Xu, Xu, Xu, Xu, Xu, Xu, Xu, Xu, Xu, Xu, Xu, Rr, Rr, Rr, Uu, Xu, Xu, Xu, Xu, Xu, Xu, Qxu, Qxu, Rr, Rr, Rr, Qxu, Xu, Xu, Xu, Xu, Xu, Xu, Xu, Xu, Xu, Xu
Xu, Xu, Xu, Xu, Xu, Xu, Xu, Xu, Xu, Xu, Xu, Xu, Xu, Xu, Xu, Uu, Uh, Uu, Uu^Uf, Xu, Xu, Xu, Xu, Xu, Xu, Xu, Xu, Qxu, Qxu, Qxu, Xu, Xu, Xu, Xu, Xu, Xu, Xu, Xu, Xu, Xu, Xu
Xu, Xu, Xu, Xu, Xu, Xu, Xu, Xu, Xu, Xu, Xu, Xu, Xu, Xu, Xu, Xu, Xu, Xu, Xu, Xu, Xu, Xu, Xu, Xu, Xu, Xu, Xu, Xu, Qxu, Xu, Xu, Xu, Xu, Xu, Xu, Xu, Xu, Xu, Xu, Xu, Xu
Xu, Xu, Xu, Xu, Xu, Xu, Xu, Xu, Xu, Xu, Xu, Xu, Xu, Xu, Xu, Xu, Xu, Xu, Xu, Xu, Xu, Xu, Xu, Xu, Xu, Xu, Xu, Xu, Uu, Xu, Xu, Xu, Xu, Xu, Xu, Xu, Xu, Xu, Xu, Xu, Xu
Xu, Xu, Xu, Xu, Xu, Xu, Xu, Xu, Xu, Xu, Xu, Xu, Xu, Xu, Xu, Xu, Xu, Xu, Xu, Xu, Xu, Xu, Xu, Xu, Xu, Xu, Xu, Xu, Xu, Xu, Xu, Xu, Xu, Xu, Xu, Xu, Xu, Xu, Xu, Xu, Xu
Xu, Xu, Xu, Xu, Xu, Xu, Xu, Xu, Xu, Xu, Xu, Xu, Xu, Xu, Xu, Xu, Xu, Xu, Xu, Xu, Xu, Xu, Xu, Xu, Xu, Xu, Xu, Xu, Xu, Xu, Xu, Xu, Xu, Xu, Xu, Xu, Xu, Xu, Xu, Xu, Xu
Xu, Xu, Xu, Xu, Xu, Xu, Xu, Xu, Xu, Xu, Xu, Xu, Xu, Xu, Xu, Xu, Xu, Xu, Xu, Xu, Xu, Xu, Xu, Xu, Xu, Xu, Xu, Xu, Xu, Xu, Xu, Xu, Xu, Xu, Xu, Xu, Xu, Xu, Xu, Xu, Xu
