border_size=1
usage=map

Gg, Gg, Gg, Gg, Gg, Gg, Gg, Gg, Gg, Gg^Fds, Gg^Fds, Gg^Fds, Gg^Fds, Gs^Fds, Hh^Fds, Gg^Fds, Mm^Xm, Mm, Mm^Xm, Mm, Mm^Xm, Gg, Hh, Xv, Xv, Mm, Mm^Xm, Mm^Xm, Mm^Xm, Gg, Hh^Fds, Hh^Fds, Gg^Fds, Gg^Fds, Gg^Fds, Gg^Fds, Gg^Fds, Gg^Fds, Gg^Fds, Gg, Gg, Gg, Gg, Gg, Gg, Gg
Gg, Gg, 1 Gg, Gg, Gg, Gg, Gg, Gg, Gg, Gg, Gg, Gg, Gs, Gg^Fds, Hh^Fds, Hh^Fds, Hh, Mm^Xm, Hh, Mm^Xm, Hh, Mm^Xm, Hh, Xv, Xv, Mm^Xm, Hh, Mm^Xm, Hh, Hh, Hh, Hh^Fds, Gs, Gs^Fds, Gg, Gg, Gg, Gg, Gg, Gg, Gs, Gg, Gg, Gg, Gg, Gg
Gg, Gg, Gg, Gg, Gg, Gg, Gs, Gg, Gg, Gs^Vh, Gg, Gg, Gg, Gg, Gs, Gs, Gg, Hh, Hh, Mm, Hh, Mm, Hh, Xv, Xv, Hh, Hh, Hh, Hh, Hh^Wm, Hh, Gg, Gg^Emf, Gg, Gg, Gg, Gs, Gs^Vh, Gg, Gg, Gg, Gs, Gg, 3 Gg, Gg, Gg
Gg, Gg, Gg, Gg, Gs, Gs, Gg, Gg, Gg, Gg, Gs, Gg, Gs, Gg, Gg, Gg, Gg, Gg, Gg, Hh, Hh, Hh, Gs, Xv, Xv, Mm, Hh, Hh, Hh, Hh, Gg, Gg^Emf, Gg, Gg, Gg^Fds, Gs, Gs^Fds, Gs, Gs, Gg, Gg, Gg, Gg, Gg, Gg, Gg
Gg, Gg, Gg, Gs, Gg, Gg, Gg, Gg, Gs^Fds, Gs, Gg^Fds, Gg^Fds, Gg, Gg^Fds, Gg^Fds, Gg, Gg, Gs, Gg, Gg, Gg^Fds, Hh, Gs, Xv, Xv, Hh, Gg, Hh, Gg^Vh, Gg, Gg, Gg^Emf, Gs^Fds, Gg^Fds, Gs, Gs^Fds, Gg^Fds, Gs, Gs, Gs, Gg, Gg, Gg, Gg, Gg, Gg
Gg, Gg, Gg, Gs, Gs, Gg, Gg, Gg^Fds, Gs, Gg, Gg, Gg, Gg, Gg, Gg, Gg, Gs, Gs, Gs, Gg, Gg^Fds, Gg, Gs, Xv, Xv, Gg, Gg, Gg, Gg, Gg, Gg, Gs, Gs, Gg, Gg, Gg, Gs, Gg, Gs, Gg, Gg, Gg, Gs, Gg, Gg, Gg
Gg, Gg, Gg, Gs, Gg, Gg, Gg, Gg, Hh, Gs, Hh, Gg, Gg, Gs, Gg, Gg, Gg, Gs, Gg^Fds, Gs^Fds, Gg, Gg, Gs, Xv, Xv, Gg, Gg, Gg, Gg, Gs, Gg, Gs, Hh, Gg, Hh, Gg, Gs, Gg, Gg, Gg, Gs, Gg, Gs^Vh, Gs, Gg, Gg
Gg, Gg, Gg, Gs^Vh, Gg, Gg, Hh, Hh, Hh, Hh, Mm^Xm, Hh, Gg, Gg, Gg, Gg, Gg^Fds, Gg^Fds, Gs^Fds, Gs, Gs^Fds, Gs, Gg, Xv, Xv, Gg, Gg, Gg, Gg, Gs, Hh, Hh, Mm, Hh, Hh, Hh, Hh, Gg, Gg, Gs, Gs, Gs, Gs, Gs, Gg, Gg
Gg, Gg, Gg, Gg, Gg, Gg, Gs, Hh, Mm^Xm, Mm^Xm, Mm^Xm, Hh, Gg, Gs^Vh, Gs^Fds, Gg^Fds, Gs^Fds, Gs^Fet, Gg^Fds, Gs^Fds, Gg, Gg, Gg, Xv, Xv, Gg, Gg, Gg, Gg^Fds, Gg, Gg, Hh, Mm, Mm, Mv, Hh, Hh, Gg, Gg, Gs, Gs^Fds, Gs^Fds, Gs, Gs, Gg, Gg
Gg, Gg, Gg, Gs, Gg, Gs, Gg, Hh, Hh, Hh, Hh, Hh, Gg, Gs^Fds, Gg^Fds, Gg^Fds, Gg, Gg^Fds, Gs, Gs, Gg, Gg, Gg, Xv, Xv, Gg, Gg, Gg^Fds, Gg^Fds, Gg, Gg, Hh, Hh, Mm^Xm, Mm, Mm, Mm, Hh, Gg, Gg, Gg^Fds, Gs^Fds, Gg, Gg, Gg, Gg
Gg, Gg, Gg^Fds, Gg^Fds, Gg, Gg, Gg, Gg, Gg, Gg, Gg, Gg, Gg^Emf, Gg^Fds, Gg^Fds, Gg^Fds, Gg, Gs, Gg, Gg, Gg, Gg, Gg, Xv, Xv, Gg, Gg, Gg, Gg^Fds, Gg^Fet, Gg, Gg, Hh, Mm, Mm, Mm, Mm, Hh, Hh^Fds, Gg^Fds, Gg, Gg^Fds, Gg, Gg, Gg, Gg
Gg, Gg, Gg, Gg^Fds, Gg^Fds, Gg^Fds, Gs^Fds, Gg, Gs, Gg, Gg^Emf, Gs^Emf, Gs, Gg, Gs, Gg, Hh, Hh, Gg, Gg, Gg, Gg, Gg, Xv, Xv, Gg, Gg, Gg, Gg, Gg^Fds, Gg^Fds, Gd, Gg, Hh, Hh, Mm, Hh, Hh, Gs^Fds, Gg^Fds, Gs, Gg, Gg, Gg, Gg, Gg
Gg, Gg, Gs, Gs, Gg, Gg, Gg, Gg^Fds, Gg, Gg, Hh, Gg, Hh, Hh, Hh, Hh, Hh, Hh, Hh, Gs, Gg, Gg, Gg, Xv, Xv, Gg, Gg, Gs^Vh, Gs, Gg, Gs^Fds, Gs, Gg, Hh, Hh, Hh, Hh, Hh^Fds, Gg^Fds, Gg^Fds, Gg, Gg, Gg, Gs, Gs, Gg
Gg, Gg, Gg, Gg, Gg, Gg, Hh, Hh, Mm, Hh, Mm, Hh, Mm, Mm, Mm, Mm, Hh, Gg, Hh, Gg, Gg, Gg, Gg, Xv, Xv, Gg, Gs, Gs, Gg, Gg, Gg^Fds, Gg, Gg, Hh, Gg, Gs, Gg, Gs^Fds, Gg, Gg, Gg, Gg^Vh, Gg, Gg, Gs, Gg
Gg, Gg, Gg, Gs^Vh, Hh, Hh, Hh, Hh, Hh, Mm, Hh, Mm, Hh, Hh, Gs, Hh, Gg, Hh, Gs, Gs, Gs, Gs, Gg, Xv, Xv, Gg, Gg, Gg, Gg, Gs^Fds, Gg, Gg, Gs, Gs, Gg, Gg^Emf, Gg^Emf, Gg, Gg, Gg, Gs, Gs, Gs, Gs, Gs, Gg
Gg, Gg, Gg, Gg, Hh, Hh, Gg, Hh, Hh, Hh, Gg, Hh, Gs, Gs, Gs, Gs, Gs, Gs, Gg, Gg, Gs^Vh, Gg, Gg, Xv, Xv, Gg, Gg, Gg, Gg, Gg, Gg, Gg, Gg, Gg, Gg, Gg^Emf, Gs, Gg, Gs, Gs, Gs, Gg, Gs, Gs, Gs, Gg
Gg, Gg, Gg, Gg, Gg, Hh, Gg, Hh, Gg^Fds, Hh, Gg^Fds, Gs^Fds, Gg, Gg, Gg, Gg, Gg, Gg, Gg, Gg, Gg, Gg, Gg, Xv, Xv, Gg, Gg, Gg, Gg, Gg, Gg, Gg, Gg, Gg, Gg, Gg, Gs, Gs, Gs, Gs, Gg, Gs, Gg, Gg, Gg, Gg
Gg, Gg, Gg, Gg^Fds, Gg^Fds, Gg^Fds, Gg^Fds, Gg^Fds, Gg, Gg^Fds, Gg, Gg, Gg, Gg, Gg, Gg, Gg, Gg, Ch, Gg, Gg, Gg, Gg, Xv, Xv, Gg, Gg, Gg, Gg, Gg, Gg, Gg, Gg, Gg, Gg, Gg, Gg, Gg, Gg, Gg, Gg, Gg, Gg, Gg, Rr, Gg
Gg, Gg^Fds, Rr, Gg, Rr, Gg, Rr, Gg, Rr, Gg, Rr, Gg, Rr, Gg, Rr, Gg, Rr, Gg, Rr, Gg, Rr, Gg, Rr, Xv, Xv, Rr, Rr, Gs, Rr, Cud, Rr, Gg, Rr, Gg, Rr, Rr, Rr, Rr, Rr, Rr, Rr, Rr, Rr, Rr, Rr, Rr
Rr, Rr, Rr, Rr, Rr, Rr, Rr, Rr, Rp^Fds, Rr, Rp^Fds, Rr, Rr, Rr, Rr, Rr, Rr, Rr, Rr, Rr, Rr, Rr, Rr, Xv, Xv, Rr, Rr, Rr, Rr, Rr, Rr, Rr, Rr, Rr, Rr, Rr, Rr, Rr, Rr, Rr, Rr, Rr, Rr, Rr, Rr, Rr
Gg, Rr, Gg, Rr, Gg, Rr, Gs^Fds, Rr, Gg, Rp^Fds, Gg, Rr, Gg, Rr, Gg, Rr, Gg, Rr, Ch, Rr, Gg, Rr, Gg, Xv, Xv, Rr, Gg, Gg, Gg, Rr, Gg, Rr, Gg, Rr, Gg, Gg, Gg, Gg, Gg, Gg, Gg, Gg, Gg, Gg, Gg, Rr
Gg, Gg, Gg, Gg, Gg, Gs^Fds, Gg, Gs^Fds, Gg, Gg, Gg, Hh, Hh, Gg^Emf, Gg, Gg, Gg, Gg, Gg, Gg, Gg, Gg, Gg, Xv, Xv, Gg, Gg, Gg, Gg, Cud, Gg, Gg, Gg, Gg, Gg, Gg, Gs, Gg^Emf, Gs^Emf, Gs, Gg, Gg, Gs, Gg, Gg, Gg
Gg, Gg, Gg, Gg, Gg, Gg, Gg, Gg, Gg, Gg, Gs, Gg, Hh, Gg, Gg, Gg, Gg, Gg, Gg, Gg, Gg, Gg, Gg, Xv, Xv, Gg, Gg, Gg, Gs, Gs, Gs, Gs, Gg, Gg, Gs^Fds, Gs^Fds, Hh^Fds, Gs, Gg, Gg, Gg, Gg^Vh, Gg, Gg, Gs, Gg
Hh, Gg, Gg, Gg, Gg^Vh, Gg, Gg, Gs, Gg, Gs^Wm, Gg, Gs^Fds, Gs, Hh^Fds, Hh^Fds, Hh, Gg, Gg, Gg, Gs^Vh, Gs, Gg, Gg, Xv, Xv, Gg, Gg, Gg, Gs^Vh, Gs, Gg, Gg, Gg, Gs^Fds, Gs^Fds, Hh^Fds, Hh^Fds, Gs, Gg, Gs, Gg^Wm, Gs, Gs, Gg, Gs, Gg
Md, Hh, Gg, Gg, Gs^Fds, Gs^Fds, Gs^Fds, Gs, Gg, Gg, Gs^Fds, Gg, Gs^Fds, Gg, Gg, Gs^Fds, Gg, Gg, Gg, Gg, Gs, Gg, Gg, Xv, Xv, Gg, Gg, Gs, Gg, Gg, Gs^Fds, Gs^Fds, Gs^Fds, Gs^Fds, Gg, Hh, Hh, Hh, Gg, Gg, Gg, Gg, Gs, Gg, Gs, Gs
Md, Hh, Gg, Gg, Gg, Gg, Hh, Gs^Fds, Gg, Gg, Gg, Gs^Fds, Gg, Gs^Fds, Gs^Fds, Gs^Fds, Gs, Gg, Gg, Gg, Gs, Gg, Gg, Xv, Xv, Gg, Gg, Gg, Gs^Fds, Gs^Fds, Gs^Fds, Gg, Gg, Gs^Fds, Gs^Fds, Hh, Gs, Gg, Gg, Gg, Gg, Gg, Gg, Gg, Gs, Hh
Md, Hh, Gg, Gg, Gg, Gg, Gg, Hh^Fds, Gs^Fds, Gg, Gg, Gg, Gg^Fet, Gg, Gg, Gs^Fds, Gs^Fds, Gs, Gs, Gs, Gg, Gg, Gg, Xv, Xv, Gg, Gg, Gg, Gs^Fds, Gs^Fds, Gg, Gg, Gs^Fds, Gg, Gg, Gg, Gg, Gg, Gs, Gg, Gs^Fds, Gg, Gs^Fds, Gs^Fds, Hh, Hh
Md, Hh, Gg, Gg, Gg, Gg, Gg, Hh, Gg, Gg, Gg, Gs^Fds, Gs^Fds, Gg, Gs^Fds, Gs^Fds, Gg, Gg, Gs^Fds, Gg, Gg, Gg, Gg, Xv, Xv, Gg, Gg, Gs, Gg, Gg, Gg, Gs^Fds, Gg, Gg, Gg, Gs, Gs, Gs, Gs^Fds, Gg^Fet, Gs^Fds, Gg, Gs^Fds, Gs^Fds, Hh, Gg
Md, Hh, Gs^Fds, Gs^Fds, Gs^Fds, Gg, Gs^Fds, Gg, Gg, Gg, Gg, Gg, Gg, Gg, Gg, Gg, Gs^Fds, Gs^Fds, Gg, Gg, Gg, Gg, Gg, Xv, Xv, Gg, Gg, Gs, Gg, Gg, Gg, Gs^Fds, Gs, Gs, Gs, Gg, Gs^Fds, Gs^Fds, Hh, Gs^Fds, Gs, Gg, Gs^Fds, Gg, Hh, Hh
Hh, Hh, Gs^Fds, Gs^Vh, Gg, Gg, Gg, Gs^Fds, Gs, Gg, Gs, Gg, Hh, Gs, Gg, Gs^Fds, Gs, Gg, Gs, Gg, Gg, Gg, Gg, Xv, Xv, Gg, Gs, Gg, Gg, Gg, Gg, Gs, Gs, Gs, Gs, Gs, Hh^Fds, Hh, Hh, Gg, Gs, Gs^Fds, Gg, Gg, Gg, Hh
Gg, Gg, Gg, Gs^Fds, Gg, Gg, Gg, Gs^Fds, Gs^Fds, Gs^Fds, Gs^Fds, Gs^Fds, Hh^Fds, Gs^Fds, Gs, Gs, Gs, Gs, Gs, Gg, Gg, Gg, Gg, Xv, Xv, Gg, Gs, Gg, Gg, Gg^Vh, Gg, Gg, Gg, Gg, Gs^Fds, Gs^Fds, Hh, Hh^Fds, Hh, Gs, Gg, Gg, Gg, Gs^Vh, Gg, Hh
Gg, Gg, Gg, Gs^Fds, Gg, Gs^Fds, Gg, Gs^Fds, Gg, Gs^Fds, Gg^Emf, Gs^Fds, Gs, Hh, Hh, Gg, Gs, Gs^Vh, Gs, Gs, Gs^Fds, Gs^Fds, Gs^Fds, Xv, Xv, Gs^Fds, Gs^Fds, Gg, Gg, Gg, Gg, Gg, Gg, Gg, Gg, Gg, Gs, Gs, Hh, Gg, Gg, Gg, Gg, Gg, Gg, Gg
Gg, Gg, 4 Gg, Gg, Gg, Gg, Gg, Gg, Gg, Gg, Gg, Gg, Gg, Gg, Gg, Gs, Gg, Gg, Gg, Gs^Fds, Md, Gs^Fds, Gs^Fds, Xv, Xv, Gs^Fds, Gs^Fds, Gs^Fds, Hh^Fds, Gg, Gg, Gg, Gg, Gg, Gg^Emf, Gg^Emf, Gg, Gg, Gg, Gg, Gg, Gg, Gg, Gg, Gg, Gg
Gg, Gg, Gg, Gg, Gg, Gg, Gs^Vh, Gg, Gg, Gg, Gg, Gg, Gg, Gg, Gg, Gg, Gs^Fds, Gs^Fds, Gs^Fds, Gs^Fds, Gs^Fds, Gs^Fds, Gs^Fds, Xv, Xv, Gs^Fds, Gs^Fds, Gs^Fds, Gs^Fds, Hh, Hh, Hh, Gs, Gg, Gs, Gg, Gs, Gs, Gg, Gs^Vh, Gg, Gg, Gg, 2 Gg, Gg, Gg
Gg, Gg, Gg, Gg, Gg, Gg, Gg, Gg, Gg, Gg, Gg, Gg, Gg, Gg, Gg, Gg, Gg, Gs^Fds, Gs^Fds, Gs^Fds, Gs^Fds, Gs^Fds, Gg, Xv, Xv, Gs^Fds, Gs^Fds, Gs^Fds, Gg, Gg, Gg, Gg, Gg, Gg, Gg, Gg, Gg, Gg, Gg, Gg, Gg, Gg, Gg, Gg, Gg, Gg
